1111111111
1P000C0E01
10C00C0001
1111111111