1111111111
1P000C1EC1
10C00C0010
1111111111