1111111
1000001
1P0C001
1111111

