111111111
100000E01
1P0C00001
111111111