11111111111
10000000P01
10010E00011
1000100C001
10000000001
10000C10001
11111111111